"filename", "language", "C#", "comment", "blank", "total"
"d:\Tuanjie Projects\UGJ2025\Assets\Scripts\Audio\AudioManager.cs", "C#", 100, 2, 20, 122
"d:\Tuanjie Projects\UGJ2025\Assets\Scripts\Audio\Sound.cs", "C#", 9, 0, 3, 12
"d:\Tuanjie Projects\UGJ2025\Assets\Scripts\CameraMove.cs", "C#", 64, 14, 12, 90
"d:\Tuanjie Projects\UGJ2025\Assets\Scripts\CameraShake.cs", "C#", 39, 4, 11, 54
"d:\Tuanjie Projects\UGJ2025\Assets\Scripts\Card.cs", "C#", 224, 13, 59, 296
"d:\Tuanjie Projects\UGJ2025\Assets\Scripts\CardData\CardData.cs", "C#", 34, 5, 8, 47
"d:\Tuanjie Projects\UGJ2025\Assets\Scripts\CardForShow.cs", "C#", 47, 2, 11, 60
"d:\Tuanjie Projects\UGJ2025\Assets\Scripts\CardVisual.cs", "C#", 252, 9, 51, 312
"d:\Tuanjie Projects\UGJ2025\Assets\Scripts\CollectionManager.cs", "C#", 34, 2, 5, 41
"d:\Tuanjie Projects\UGJ2025\Assets\Scripts\CutoffMaskUI.cs", "C#", 17, 0, 2, 19
"d:\Tuanjie Projects\UGJ2025\Assets\Scripts\DeckManager.cs", "C#", 65, 17, 12, 94
"d:\Tuanjie Projects\UGJ2025\Assets\Scripts\DialogueManager.cs", "C#", 105, 41, 26, 172
"d:\Tuanjie Projects\UGJ2025\Assets\Scripts\EndPanel.cs", "C#", 37, 4, 8, 49
"d:\Tuanjie Projects\UGJ2025\Assets\Scripts\HorizontalCardHolder.cs", "C#", 189, 14, 50, 253
"d:\Tuanjie Projects\UGJ2025\Assets\Scripts\Map\LevelSelectRoot.cs", "C#", 19, 1, 3, 23
"d:\Tuanjie Projects\UGJ2025\Assets\Scripts\Map\MapGrid.cs", "C#", 58, 4, 11, 73
"d:\Tuanjie Projects\UGJ2025\Assets\Scripts\Map\MapGridManager.cs", "C#", 103, 3, 25, 131
"d:\Tuanjie Projects\UGJ2025\Assets\Scripts\Map\PlayerInMap.cs", "C#", 177, 6, 28, 211
"d:\Tuanjie Projects\UGJ2025\Assets\Scripts\PanelManager.cs", "C#", 67, 2, 12, 81
"d:\Tuanjie Projects\UGJ2025\Assets\Scripts\PlayerSwitchManager.cs", "C#", 76, 2, 15, 93
"d:\Tuanjie Projects\UGJ2025\Assets\Scripts\Room\EnemyUnit.cs", "C#", 160, 14, 38, 212
"d:\Tuanjie Projects\UGJ2025\Assets\Scripts\Room\GameGrid.cs", "C#", 72, 6, 16, 94
"d:\Tuanjie Projects\UGJ2025\Assets\Scripts\Room\GridNode.cs", "C#", 16, 0, 3, 19
"d:\Tuanjie Projects\UGJ2025\Assets\Scripts\Room\HealthSystem.cs", "C#", 46, 9, 12, 67
"d:\Tuanjie Projects\UGJ2025\Assets\Scripts\Room\IsoGrid2D.cs", "C#", 258, 9, 59, 326
"d:\Tuanjie Projects\UGJ2025\Assets\Scripts\Room\UnitController.cs", "C#", 198, 12, 45, 255
"d:\Tuanjie Projects\UGJ2025\Assets\Scripts\ShaderCode.cs", "C#", 45, 8, 14, 67
"d:\Tuanjie Projects\UGJ2025\Assets\Scripts\Store.cs", "C#", 24, 2, 8, 34
"d:\Tuanjie Projects\UGJ2025\Assets\Scripts\TurnManager.cs", "C#", 101, 5, 23, 129
"d:\Tuanjie Projects\UGJ2025\Assets\Scripts\VisualCardsHandler.cs", "C#", 17, 2, 7, 26
"d:\Tuanjie Projects\UGJ2025\Assets\Scripts\_SciptableObjects\CurveParameters.cs", "C#", 9, 0, 2, 11
"d:\Tuanjie Projects\UGJ2025\Assets\Scripts\_Utility\ExtensionMethods.cs", "C#", 7, 0, 2, 9
"Total", "-", 2669, 212, 601, 3482